a:map_01 332 574
o:badguy.png 10 10 1#a:map_01a 332 574
1, 1, 1, 1, a, 1, 1, 1, 1
1, 0, 0, 0, 0, 0, 0, 0, 1
1, 0, 0, 0, 0, 0, 0, 0, 1
1, 0, 0, 0, 0, 0, 0, 0, 1
1, 0, 0, 0, 0, 0, 0, 0, 1
1, 0, 0, 0, 0, 0, 0, 0, 1
1, 0, 0, 0, o, 0, 0, 0, 1
1, 1, 1, 1, 1, 1, 1, 1, 1
